11111111111
1E000000001
10000000001
10000000001
10000000001
10000000001
10000000001
10000000001
10000000001
10000000001
10000000001
1P0000000C1
10000000001
10000000001
10000000001
1C000000001
11111111111