11111111111111111111111111111111
10000000000000000000000000000001
10000000000000000000000000000001
10000000000000000000000000000001
10000000001111111111111111000001
10000000000000000100000000000001
10000000000000000100000000000001
10000000000000EC0100C00000000001
10000000000000000100000000000001
10000000001111111111100000000001
100000000010P0000000000000000001
10000000001000000000000000000001
10000000001000000000000000000001
10000000000000000000000000000001
10000000000000000000000000000001
10000000000000000000000000000001
10000000000000000000000000000001
11111111111111111111111111111111